0000000000000
0000000000000
0000000000000
0000000000000
1110000000111
0000000000000
0000000000000
1111111111111
