0000000000000
0000000000000
0000000000000
1110000000111
0000000000000
0000000000000
000R00G00B000
111r11g11b111
